7
***5***
*****2* 
*5*4***
****5*2
*******
******5
*0*0***