16
****5**11******0
0***0****5***0**
5*5******551*1**
**5*0*0*0*0****5
2******5****50*0
*****2*********0
25*5*******55***
***5*0*****0**0*
*5**55********1*
***5**5**3******
05*********1****
*1**5***5******5
*0*0***3******5*
***5**2**0**2***
*1051*****2*****
**1****05*******